30,25
16,41
00000000000000000000000000000000000000000000000000
11111111111111111111111111111111111111111111111110
10000000000000000000000000000010000000100000100010
10111111101111111111101111111010111110101110101010
10100000101000001000100010001000101000100010001010
10101110111011101010101010111111101011101111111010
10101010000010000010101010000000001010001000001010
11101011111011111110111011111111101011101011101010
10001000000010000010001010000000101000101010001010
10111111111110111011101010111110101110111010111010
10000000100000001010000010101000100000000010100010
10111110101111111011111110101011111111111110101110
10100010100000100010001000001000000010000010100010
10101010101111101010101011111111111010101010111010
10101010001000101010100000100000000010101010000010
10101011111010101110111111101111111111101111111010
10001010000010101000100010001000100000100000100010
11101110111110101011101010111010101110101110101110
10001000100010100010001010000010101000100010101010
11111011111010111110111010111110101011111010101010
10001010000010001000100010000010001010000010001010
10101010111011101011101111101111111010111111111010
10100010100000100010001000001000001010000000000010
10111110111011111110111111111011101011111111111110
10001000001010000010000000000010101000000000000010
11101011101110111010111111111110101011111111111010
10001000100000101000100010000010001000001000000010
10111110111111101111101010101010111111111011111010
10100010100000001000001010101010100010001010001010
10101010101110101011111011101010101010101010111010
10101010100010101010100010101010101000101010100010
10101110111010111010101110101010101111101010101110
10101000100010100010100000101010100010000010100010
10101011111110101110111111101110101011111110111010
10100000001000100000001000100010101000100000001010
10111111101011111111101010101010101110101111101010
10000010000010000000101010101000101010101000101010
10111011111110111110101011101111101010101110101010
10100010000010001010001000101000000010100010100010
11101010111011101011111110101111111010111010111110
10001010100000100000001000100000100010100000000010
10101110101110111111101011111110101110111111111010
10101000100010000010001010000000101000100000001010
10111011111011111010111010111111111011101111101010
10100000001010001010101000100000001010001000101010
10101111111010101110101011101111101010111010101110
10001000000010100010100010001000001000000010100010
10111011111110111010101110111011111111111111111010
10001000000000001000100000100000000000000000000010
11111111111111111111111111111111111111111111111110

