23,2 28,11
111111111111111111111111111111
100000100010001001000111111111
101011001000100101010010111111
101011010011010001011000111111
101000001000010101001010011111
100101111011000010010001011111
101110000110011000100100011111
100110110001011011010101001111
101000101100010000000010101111
101010100011010111011000100111
100010001000001000100010010001
101010101101110010001010100101
100001000000000100110001101011
101101011010101001000110001001
110000011101000110010000110101
100101000000010001010101000001
101000101010111101001001010111
100010010010010000110010010001
101000100101000110000101101101
101010101100010001011000000101
100100001001001010000110110001
110011010010101001010010011011
101000010100000100001001001001
100101010101110101010100100101
110101001001000101100010010011
100000101010011100101001001001
101101000010100001000101100011
101010011010101110011000110101
100000100000000000100010000001
111111111111111111111111111111
