15,8 7,1
11111111111111111111
10000010000010100101
11011001101100010001
11001101001001000101
11100101010011010101
11110100000100001001
10000111011101100101
10111111100011110011
10111111101011101001
10011111001011001011
11011111011011011001
11000000011000010101
10111111101111100101
10000000100001010101
10101110101100000101
10100010101001110101
10011001000100011001
11010101010011000101
10000100001000110001
11111111111111111111
