2,1 9,5
1111111111111111111111111
1100011110000100000010101
1011001110110001011010001
1000100110111111001000101
1010110010111111101011001
1010011010111111101100011
1001001011111111101001101
1100101011111100001011001
1010101011111001111000011
1000101001110011000111001
1011100100110100011000011
1100010010000110110011101
1001001001111000100100001
1010101010000011001110101
1010001010111001010110101
1011100010100101010000101
1000011010101001001101001
1011000100101010101101011
1001010101001000100001011
1100110001101010010111001
1010001010001001001000011
1000100111010100101011101
1011010010000010110000101
1000001000101010000110001
1111111111111111111111111
