5,12 15,12
11111111111111111111
10000100010100001011
10110011000001010001
10001000101010110101
11100110011000000101
10010101010011111001
10101101001000000101
10000000101111010101
10101111100001111101
10010000011101000001
10100110111101011101
10101010111001011001
10100010011010011011
10011001001000111001
10100100100111111101
10001110010001111101
10100110110111111101
10111000010111111001
10000011010000000011
11111111111111111111
