3,2 5,2
11111111111111111111111111111111111111111111111111
11000110001000001111111111100000110000000001111111
10010000100010110000011111001110001010111100111011
10100111001010010111001000011111101100100010001001
10011100010101010111100011111111100001010111100101
10100001100000010000010111110001011110000011110001
11001101110101101111010011110110000010101001101011
10011000100010000101001001000100101100110100001001
11000110010100110001100111011001000010000011010011
10010001001001000100010000011101011001110111000101
10100100111010101010101111111000100100010010101101
10010101000010101000100000010010010010101000101001
11100010011100100101001011010101000100001010010011
10001100100001001000110010100100111110100100100101
10100101010100101010100100001001000100011001001001
10110100001010100100001001110010010111000100010011
10001011100000110011101010000100110000110011001001
10100000111110001000010011010010001110000111101101
10011011000001010110110100010101100011111011000001
11001000010100000010000001100000011000000000010101
11111111111111111111111111111111111111111111111111