21,15 28,15
11111111111111111111
10001111000101001001
10100110010000100101
10111000111010010001
10000010010010110101
10101101110100001001
10010000000101101011
10110111011010100011
11000100100000111001
10011001001010000101
11000101010011110101
10010101001000011001
10100100010111000011
10110101000000110101
10010010101110001101
10110100010001100001
11000101001010011101
11011100100001000001
10010001010111011011
10111010001000010001
10010000100011100111
11010101110100011001
10011010001001010011
11000010100011000111
11011010011111111111
10010001001111111111
10100100101111111111
11001010100111111111
10010001010001101111
11000100001100101111
10011110100110100111
10100100010010010011
10110101110101011011
10000100001001001001
11110010100010100101
10001001001000010001
10110010010111101101
10001010100000000101
10100010001010110001
11111111111111111111
test