7,16 4,2
11111111111111111111
11000000011111111111
11011111000111111111
11000100110111111111
10110101010111110001
10010101010001111101
10100100001100011101
10101010100011001001
10110010011000100011
10000101000110011001
11010100110101011101
10010010000101001101
10111000111000100001
10010111001010111011
11010100100010000101
10010001010101101001
11001011000100000011
10101000010110111111
10101111110001000011
10100000001100011001
10111101101001000101
10000010001010110101
10110100110100010101
11000010100001001001
10010100101011100011
10100010010001011011
10101101001010001001
10011000101010110101
11000010000010000001
11111111111111111111
